WE                     ./assets/wwe.xpm
NO ./assets/wno.xpm
EA               ./assets/wea.xpm
SO ./assets/wso.xpm

S ./assets/slight.xpm

R 1600 900

C  7,50 ,200
F 155,155,155
     
     111111111111111111
    1000000000000000001
    1000020001010000001
  11100000000000000011 111
  100000002000001000001 101
  10000000000000000001 111
  1111111111111111111
 
     
  11111111111111111
 100000000000000001
100000S001010000201
10000000000000000001
10000000200101000001
 1000000001 10000001
  11111111111111111
  11
