WE ./assets/wall_skull.xpm
NO  ./assets/wall_mossy.xpm
EA ./assets/wall_wither.xpm
SO ./assets/wall_pig.xpm
S ./assets/red.xpm

R 1600 900

F 0,0,0


C 255,255,255

1111
1W21
1111
