R 1536 864

WE ./assets/wwe.xpm
NO ./assets/wno.xpm
EA ./assets/wea.xpm
SO ./assets/wso.xpm
S ./assets/slamp.xpm

F 155,155,155


C 50,50,200


    111111111111111111
    1000000000000000001
    10000S0001010220001
  11100000000000022001 111
  10000022200001220001 101
  10000000000000000001 111
  1111111111111111111
      
      
  11111111111111111
 1000000000000000001
1000000001010220001
10000000000000022001
10000022200001220001
 1000000000000000001
  11111111111111111
