WE ./assets/2.xpm
NO ./assets/2.xpm
EA ./assets/2.xpm
SO ./assets/2.xpm

S ./assets/2.xpm

R 800 900

C  7,50 ,200
F 155,155,155
     
    111111111111111111
    1000000000000000001
    1000000001010220001
  11100000000000022001 111
  10000022200001220001 101
  10000000000000000001 111
  1111111111111111111
      
    
  11111111111111111
 100000000000000001
100000S001010220001
10000000000000022001
10000022200101220001
 1000000001 10000001
  11111111111111111
 
  11