R 1920 1080
WE ./assets/brick_w.xpm
NO ./assets/brick_n.xpm
EA ./assets/brick_e.xpm
SO ./assets/brick_s.xpm
S ./assets/brick.xpm

F 255,22,22
C 111,18,18

11111111111111111
11000000000010011
10001001000000001
10000000001000001
10010000000101001
10000000000000001
10000000000010001
10000100000000001
10000000N00000001
10010000000001001
11000000100000001
10000000000000011
10000000000000001
10000000000001001
10010010000000001
10000000001000001
11111111111111111